#####################
# F *   B ***  * 1  #
# # #b # # #*# # # ##
# d  d*S  S  **  B  #
# # # oS# F  #*  B  #
#*#*F*# F # # #B# # #
#*  *  d b b  *    S#
# # # # #*# # #*O***#
#* S  **  B  d  L   #
#*#*# # # # # F # # #
#  d L d S  *   Fb  #
# #*B # S #*#F**#B*S#
#S B  L * Sd B*  *d #
#  FB F   # # # # # #
# 2    B  #o   o   O #
#####################
