#####################
#d  * o B **L  F 1  #
# # #  # # #*# # # ##
#  O  *S  S  *L  B  #
# # #  S# F  #*  B  #
#*#*F*# F # # #BS F #
#*  *  o   o  *    S#
# # # # #*# # #S**L*#
#* S d**  B     Lbbb#
#B#*#L# # # # F #b#b#
#    L # S  *   Fbbb#
# S*B  *F*#*#F**#B*S#
#L B FS#* S  B*  *  #
# S F  *# # # # # # #
# 2       #  o   o  #
#####################
