#####################
# b *   B ***  * 1  #
# # #  # # #*# # # ##
# b   * S S  **  B  #
# # # oS# F  #*  B  #
#*#*F # F # # #B# # #
#*  *  b  d   *    S#
# # # # #*# # #*O***#
#* S  d*  B     L   #
# #*# # # # # F # # #
#    L   S  *   F   #
#*#*B*#S**#*#F *#B*S#
#  F  S * S  B*  *  #
#B#* L *# # # # # # #
# 2   B # o   o     #
#####################
